"aa" = (/turf/template_noop,/area/template_noop)
"ab" = (/turf/closed/wall/r_wall,/area/ruin/powered)
"ac" = (/obj/item/bedsheet/orange,/obj/structure/bed/pod,/obj/effect/decal/cleanable/blood,/turf/open/floor/engine,/area/ruin/powered)
"ad" = (/obj/item/bedsheet/orange,/obj/structure/bed/pod,/turf/open/floor/engine,/area/ruin/powered)
"ae" = (/obj/item/bedsheet/orange,/obj/structure/bed/pod,/mob/living/simple_animal/hostile/retaliate/clown/mutant,/turf/open/floor/engine,/area/ruin/powered)
"af" = (/turf/open/floor/engine,/area/ruin/powered)
"ag" = (/obj/effect/decal/cleanable/blood,/mob/living/simple_animal/hostile/retaliate/clown/mutant,/turf/open/floor/engine,/area/ruin/powered)
"ah" = (/mob/living/simple_animal/hostile/retaliate/clown/mutant,/turf/open/floor/engine,/area/ruin/powered)
"ai" = (/obj/effect/decal/cleanable/blood,/turf/open/floor/engine,/area/ruin/powered)
"aj" = (/obj/effect/spawner/structure/window/reinforced,/obj/machinery/door/poddoor,/turf/open/floor/plating,/area/ruin/powered)
"ak" = (/obj/machinery/door/airlock/highsecurity,/obj/machinery/door/poddoor,/turf/open/floor/engine,/area/ruin/powered)
"al" = (/obj/machinery/rnd/server,/turf/open/floor/circuit,/area/ruin/powered)
"am" = (/turf/open/floor/circuit,/area/ruin/powered)
"an" = (/obj/structure/table,/turf/open/floor/plasteel,/area/ruin/powered)
"ao" = (/obj/effect/decal/cleanable/blood,/turf/open/floor/plasteel,/area/ruin/powered)
"ap" = (/turf/open/floor/plasteel,/area/ruin/powered)
"aq" = (/obj/machinery/blackbox_recorder,/turf/open/floor/circuit,/area/ruin/powered)
"ar" = (/obj/machinery/telecomms/message_server,/turf/open/floor/circuit,/area/ruin/powered)
"as" = (/obj/structure/chair/office{dir = 1},/turf/open/floor/plasteel,/area/ruin/powered)
"at" = (/obj/machinery/door/airlock/command,/turf/open/floor/plasteel,/area/ruin/powered)
"au" = (/obj/machinery/door/airlock/research,/turf/open/floor/plasteel,/area/ruin/powered)
"av" = (/obj/structure/closet/secure_closet/RD,/turf/open/floor/plasteel,/area/ruin/powered)
"aw" = (/obj/structure/chair/office{dir = 4},/turf/open/floor/plasteel,/area/ruin/powered)
"ax" = (/obj/structure/table,/obj/structure/window/reinforced{dir = 4},/turf/open/floor/plasteel,/area/ruin/powered)
"ay" = (/obj/machinery/rnd/experimentor,/turf/open/floor/circuit/green,/area/ruin/powered)
"az" = (/obj/structure/window/reinforced{dir = 4},/turf/open/floor/circuit/green,/area/ruin/powered)
"aA" = (/obj/machinery/rnd/destructive_analyzer,/obj/structure/window/reinforced{dir = 8},/turf/open/floor/circuit/red,/area/ruin/powered)
"aB" = (/obj/machinery/rnd/production/circuit_imprinter,/turf/open/floor/circuit/red,/area/ruin/powered)
"aC" = (/obj/effect/spawner/structure/window/reinforced,/turf/open/floor/plating,/area/ruin/powered)
"aD" = (/obj/machinery/computer/rdconsole/experiment,/turf/open/floor/circuit/green,/area/ruin/powered)
"aE" = (/turf/open/floor/circuit/green,/area/ruin/powered)
"aF" = (/turf/open/floor/circuit/red,/area/ruin/powered)
"aG" = (/obj/machinery/computer/rdconsole/core{dir = 8},/turf/open/floor/circuit/red,/area/ruin/powered)
"aH" = (/obj/machinery/computer/communications,/turf/open/floor/carpet/royalblue,/area/ruin/powered)
"aI" = (/obj/machinery/computer/card,/turf/open/floor/carpet/royalblue,/area/ruin/powered)
"aJ" = (/obj/machinery/computer/camera_advanced,/turf/open/floor/carpet/royalblue,/area/ruin/powered)
"aK" = (/obj/machinery/computer/secure_data,/turf/open/floor/carpet/royalblue,/area/ruin/powered)
"aL" = (/obj/machinery/computer/med_data,/turf/open/floor/carpet/royalblue,/area/ruin/powered)
"aM" = (/obj/structure/table,/obj/structure/window/reinforced,/turf/open/floor/plasteel,/area/ruin/powered)
"aN" = (/obj/structure/table,/obj/structure/window/reinforced,/obj/structure/window/reinforced{dir = 4},/turf/open/floor/plasteel,/area/ruin/powered)
"aO" = (/obj/structure/window/reinforced,/turf/open/floor/circuit/green,/area/ruin/powered)
"aP" = (/obj/structure/window/reinforced,/obj/structure/window/reinforced{dir = 4},/turf/open/floor/circuit/green,/area/ruin/powered)
"aQ" = (/obj/machinery/rnd/production/protolathe,/obj/structure/window/reinforced,/obj/structure/window/reinforced{dir = 8},/turf/open/floor/circuit/red,/area/ruin/powered)
"aR" = (/obj/machinery/rnd/production/techfab,/obj/structure/window/reinforced,/turf/open/floor/circuit/red,/area/ruin/powered)
"aS" = (/obj/structure/chair/office{dir = 1},/turf/open/floor/carpet/royalblue,/area/ruin/powered)
"aT" = (/obj/structure/closet/crate,/turf/open/floor/plasteel,/area/ruin/powered)
"aU" = (/obj/machinery/computer/cargo{dir = 4},/turf/open/floor/carpet/royalblue,/area/ruin/powered)
"aV" = (/obj/structure/chair/office{dir = 8},/turf/open/floor/carpet/royalblue,/area/ruin/powered)
"aW" = (/turf/open/floor/carpet/royalblue,/area/ruin/powered)
"aX" = (/obj/machinery/computer/bounty{dir = 4},/turf/open/floor/carpet/royalblue,/area/ruin/powered)
"aY" = (/obj/structure/lattice/catwalk,/turf/open/space/basic,/area/ruin/powered)
"aZ" = (/obj/machinery/door/airlock/command,/turf/open/floor/carpet/royalblue,/area/ruin/powered)
"ba" = (/obj/structure/closet/emcloset,/turf/open/floor/plasteel,/area/ruin/powered)
"bb" = (/obj/item/bedsheet/orange,/obj/structure/bed/pod,/obj/effect/spawner/lootdrop/maintenance,/obj/effect/decal/cleanable/blood,/obj/effect/mob_spawn/human/clown/corpse,/turf/open/floor/plasteel,/area/ruin/powered)
"bc" = (/obj/item/bedsheet/orange,/obj/structure/bed/pod,/obj/effect/decal/cleanable/blood,/obj/effect/mob_spawn/human/doctor,/turf/open/floor/plasteel,/area/ruin/powered)
"bd" = (/obj/machinery/door/airlock/external,/turf/open/floor/engine,/area/ruin/powered)
"be" = (/obj/structure/table,/obj/machinery/chem_dispenser/drinks/fullupgrade,/turf/open/floor/plasteel,/area/ruin/powered)
"bf" = (/obj/structure/table,/obj/machinery/chem_dispenser/drinks/beer/fullupgrade,/turf/open/floor/plasteel,/area/ruin/powered)
"bg" = (/obj/effect/spawner/lootdrop/maintenance,/turf/open/floor/plasteel,/area/ruin/powered)
"bh" = (/obj/machinery/suit_storage_unit/standard_unit,/turf/open/floor/engine,/area/ruin/powered)
"bi" = (/obj/effect/decal/hammerandsickle,/turf/open/floor/plasteel,/area/ruin/powered)
"bj" = (/obj/structure/closet/l3closet,/turf/open/floor/plasteel,/area/ruin/powered)
"bk" = (/obj/machinery/door/airlock/security/glass,/turf/open/floor/plasteel,/area/ruin/powered)
"bl" = (/obj/machinery/vending/boozeomat/all_access,/turf/open/floor/plasteel,/area/ruin/powered)
"bm" = (/obj/machinery/vending/cigarette,/turf/open/floor/plasteel,/area/ruin/powered)
"bn" = (/obj/machinery/vending/autodrobe,/turf/open/floor/plasteel,/area/ruin/powered)
"bo" = (/obj/machinery/vending/assist,/turf/open/floor/plasteel,/area/ruin/powered)
"bp" = (/obj/item/bedsheet/orange,/obj/structure/bed/pod,/obj/effect/spawner/lootdrop/maintenance,/obj/effect/mob_spawn/human/cook,/turf/open/floor/plasteel,/area/ruin/powered)
"bq" = (/obj/machinery/door/airlock/public/glass,/turf/open/floor/plasteel,/area/ruin/powered)
"br" = (/obj/structure/table,/obj/machinery/computer/secure_data/laptop,/turf/open/floor/plasteel,/area/ruin/powered)
"bs" = (/obj/structure/table,/obj/effect/spawner/lootdrop/maintenance,/turf/open/floor/plasteel,/area/ruin/powered)
"bt" = (/obj/structure/closet/crate/secure/loot,/obj/effect/spawner/lootdrop/armory_contraband/metastation,/obj/effect/spawner/lootdrop/armory_contraband/metastation,/obj/effect/spawner/lootdrop/armory_contraband/metastation,/obj/effect/spawner/lootdrop/armory_contraband/metastation,/turf/open/floor/engine,/area/ruin/powered)
"bu" = (/obj/machinery/vending/cola/shamblers,/turf/open/floor/plasteel,/area/ruin/powered)
"bv" = (/obj/machinery/vending/clothing,/turf/open/floor/plasteel,/area/ruin/powered)
"bw" = (/obj/machinery/vending/coffee,/turf/open/floor/plasteel,/area/ruin/powered)
"bx" = (/obj/machinery/vending/games,/turf/open/floor/plasteel,/area/ruin/powered)
"by" = (/obj/machinery/vending/donksofttoyvendor,/turf/open/floor/plasteel,/area/ruin/powered)
"bz" = (/obj/machinery/vending/boozeomat,/turf/open/floor/plasteel,/area/ruin/powered)
"bA" = (/obj/machinery/vending/cart,/turf/open/floor/plasteel,/area/ruin/powered)
"bB" = (/obj/machinery/nuclearbomb,/turf/open/floor/engine,/area/ruin/powered)
"bC" = (/obj/machinery/door/airlock/vault,/turf/open/floor/engine,/area/ruin/powered)
"bD" = (/obj/machinery/door/airlock/security,/turf/open/floor/plasteel,/area/ruin/powered)
"bE" = (/obj/structure/closet/secure_closet/security,/turf/open/floor/plasteel,/area/ruin/powered)
"bF" = (/obj/structure/closet/secure_closet/armory2,/turf/open/floor/plasteel,/area/ruin/powered)
"bG" = (/obj/structure/closet/secure_closet/armory1,/turf/open/floor/plasteel,/area/ruin/powered)
"bH" = (/obj/structure/closet/secure_closet/armory3,/turf/open/floor/plasteel,/area/ruin/powered)
"bI" = (/obj/structure/closet/crate/silvercrate,/turf/open/floor/engine,/area/ruin/powered)
"bJ" = (/obj/structure/closet/crate/goldcrate,/turf/open/floor/engine,/area/ruin/powered)
"bK" = (/obj/machinery/vending/cola/black,/turf/open/floor/plasteel,/area/ruin/powered)
"bL" = (/obj/machinery/vending/cola,/turf/open/floor/plasteel,/area/ruin/powered)
"bM" = (/obj/machinery/vending/dinnerware,/turf/open/floor/plasteel,/area/ruin/powered)
"bN" = (/obj/structure/chair/office{dir = 8},/turf/open/floor/plasteel,/area/ruin/powered)
"bO" = (/obj/machinery/door/airlock/highsecurity,/turf/open/floor/plasteel,/area/ruin/powered)
"bP" = (/obj/machinery/door/airlock/medical,/turf/open/floor/plasteel,/area/ruin/powered)
"bQ" = (/obj/machinery/door/airlock/engineering,/turf/open/floor/plating,/area/ruin/powered)
"bR" = (/obj/machinery/sleeper/syndie/fullupgrade,/turf/open/floor/plasteel,/area/ruin/powered)
"bS" = (/obj/effect/spawner/lootdrop/maintenance,/turf/open/floor/plating,/area/ruin/powered)
"bT" = (/turf/open/floor/plating,/area/ruin/powered)
"bU" = (/obj/machinery/vending/engineering,/turf/open/floor/plating,/area/ruin/powered)
"bV" = (/obj/machinery/door/airlock/highsecurity,/turf/open/floor/plating,/area/ruin/powered)
"bW" = (/obj/structure/rack,/obj/effect/spawner/lootdrop/maintenance/three,/turf/open/floor/plating,/area/ruin/powered)
"bX" = (/obj/structure/closet/radiation,/turf/open/floor/plating,/area/ruin/powered)
"bY" = (/obj/structure/closet/firecloset,/turf/open/floor/plasteel,/area/ruin/powered)
"bZ" = (/obj/structure/rack,/obj/effect/spawner/lootdrop/maintenance,/turf/open/floor/plating,/area/ruin/powered)
"ca" = (/obj/machinery/power/supermatter_crystal,/turf/open/floor/plating,/area/ruin/powered)
"cb" = (/obj/machinery/chem_heater,/turf/open/floor/plasteel,/area/ruin/powered)
"cc" = (/obj/machinery/chem_master,/turf/open/floor/plasteel,/area/ruin/powered)
"cd" = (/obj/machinery/chem_dispenser/fullupgrade,/turf/open/floor/plasteel,/area/ruin/powered)
"ce" = (/obj/item/wallframe/apc,/turf/open/floor/plating,/area/ruin/powered)
"cf" = (/obj/structure/table,/obj/machinery/door/firedoor,/turf/open/floor/plasteel,/area/ruin/powered)
"cg" = (/obj/machinery/smartfridge/chemistry/preloaded,/obj/machinery/door/firedoor,/turf/closed/wall/r_wall,/area/ruin/powered)
"ch" = (/obj/structure/closet/l3closet/virology,/turf/open/floor/plasteel,/area/ruin/powered)
"ci" = (/obj/machinery/smartfridge/organ,/turf/open/floor/plasteel,/area/ruin/powered)
"cj" = (/obj/machinery/smartfridge/food,/turf/open/floor/plasteel,/area/ruin/powered)
"ck" = (/obj/machinery/smartfridge/chemistry/virology/preloaded,/turf/open/floor/plasteel,/area/ruin/powered)
"cl" = (/obj/machinery/smartfridge/chemistry/preloaded,/turf/open/floor/plasteel,/area/ruin/powered)
"cm" = (/obj/structure/table/glass,/turf/open/floor/plasteel,/area/ruin/powered)
"cn" = (/obj/structure/bed/pod,/obj/item/bedsheet/orange,/obj/effect/mob_spawn/human/corpse/damaged,/turf/open/floor/plasteel,/area/ruin/powered)
"co" = (/obj/machinery/door/airlock/medical,/obj/machinery/door/firedoor,/turf/open/floor/plasteel,/area/ruin/powered)
"cp" = (/obj/effect/mob_spawn/human/clown/corpse,/turf/open/floor/plasteel,/area/ruin/powered)
"cq" = (/obj/machinery/door/airlock/virology,/turf/open/floor/plasteel,/area/ruin/powered)
"cr" = (/obj/effect/mob_spawn/human/corpse/damaged,/turf/open/floor/plasteel,/area/ruin/powered)
"cs" = (/obj/structure/chair/office,/turf/open/floor/plasteel,/area/ruin/powered)
"ct" = (/obj/structure/closet,/turf/open/floor/plasteel,/area/ruin/powered)
"cu" = (/obj/structure/table,/obj/machinery/computer/med_data/laptop{dir = 1; pixel_y = 4},/turf/open/floor/plasteel,/area/ruin/powered)
"cv" = (/obj/structure/table,/obj/item/storage/backpack/duffelbag/med/surgery,/turf/open/floor/plasteel,/area/ruin/powered)
"cw" = (/obj/structure/table/optable,/obj/effect/mob_spawn/human/engineer,/turf/open/floor/plasteel,/area/ruin/powered)
"cx" = (/obj/machinery/computer/operating{dir = 1},/turf/open/floor/plasteel,/area/ruin/powered)
"cy" = (/obj/item/bedsheet/orange,/obj/structure/bed/pod,/obj/effect/mob_spawn/human/corpse/damaged,/turf/open/floor/plasteel,/area/ruin/powered)
"cz" = (/obj/item/bedsheet/orange,/obj/structure/bed/pod,/obj/effect/decal/cleanable/blood,/obj/effect/mob_spawn/human/corpse/damaged,/turf/open/floor/plasteel,/area/ruin/powered)

(1,1,1) = {"
aaaaaaaaaaaaaaaaaaaaaaaaaaaaaaaaaaaaaaaaaaaaaaaaaaaaaaaaaaaaaaaaaaaaaaaaaaaaaaaaaaaaaaaaaaaaaaaaaaaa
aaaaaaaaaaaaaaaaaaaaaaaaaaaaaaaaaaaaaaaaaaaaaaaaaaaaaaaaaaaaaaaaaaaaaaaaaaaaaaaaaaaaaaaaaaaaaaaaaaaa
aaaaaaaaaaaaaaaaaaaaaaaaaaaaaaaaaaaaaaaaaaaaaaaaaaaaaaaaaaaaaaaaaaaaaaaaaaaaaaaaaaaaaaaaaaaaaaaaaaaa
aaaaaaaaaaaaaaaaaaaaaaaaaaaaaaaaaaaaaaaaaaaaaaaaaaaaaaaaaaaaaaaaaaaaaaaaaaaaaaaaaaaaaaaaaaaaaaaaaaaa
aaaaaaaaaaaaaaaaaaaaaaaaaaaaaaaaaaaaaaaaaaaaaaaaaaaaaaaaaaaaaaaaaaaaaaaaaaaaaaaaaaaaaaaaaaaaaaaaaaaa
aaaaaaaaaaaaaaaaaaaaaaaaaaaaaaaaaaaaaaaaaaaaaaaaaaaaaaaaaaaaaaaaaaaaaaaaaaaaaaaaaaaaaaaaaaaaaaaaaaaa
aaaaaaaaaaaaaaaaaaaaaaaaaaaaaaaaaaaaaaaaaaaaaaaaaaaaaaaaaaaaaaaaaaaaaaaaaaaaaaaaaaaaaaaaaaaaaaaaaaaa
aaaaaaaaaaaaaaaaaaaaaaaaaaaaaaaaaaaaaaaaaaaaaaaaaaaaaaaaaaaaaaaaaaaaaaaaaaaaaaaaaaaaaaaaaaaaaaaaaaaa
aaaaaaaaaaaaaaaaaaaaaaaaaaaaaaaaaaaaaaaaaaaaaaaaaaaaaaaaaaaaaaaaaaaaaaaaaaaaaaaaaaaaaaaaaaaaaaaaaaaa
aaaaaaaaaaaaaaaaaaaaaaaaaaaaaaaaaaaaaaaaaaaaaaaaaaaaaaaaaaaaaaaaaaaaaaaaaaaaabababababababaaaaaaaaaa
aaaaaaaaaaaaaaaaaaaaaaaaaaaaaaaaaaaaaaaaaaaaaaaaaaaaaaaaaaaaaaaaaaaaaaaaaaaaabacadaeacacabaaaaaaaaaa
aaaaaaaaaaaaaaaaaaaaaaaaaaaaaaaaaaaaaaaaaaaaaaaaaaaaaaaaaaaaaaaaaaaaaaaaaaaaabafagafahaiabaaaaaaaaaa
aaaaaaaaaaaaaaaaaaaaaaaaaaaaaaaaaaaaaaaaaaaaaaaaaaaaaaaaaaaaaaaaaaaaabababababajajajabakabaaaaaaaaaa
aaaaaaaaaaaaaaaaaaaaaaaaaaaaaaaaaaaaaaaaaaaaaaaaaaaaaaaaaaaaaaaaaaaaabalamalabanananaoapabaaaaaaaaaa
aaaaaaaaaaaaaaaaaaaaaaaaaaaaaaaaaaaaaaaaaaaaaaaaaaaaaaaaaaaaaaaaaaaaabaqamarabaoasapapaoabaaaaaaaaaa
aaaaaaaaaaaaaaaaaaaaaaaaaaaaaaaaaaaaaaaaaaaaaaaaaaaaaaaaaaaaaaaaaaaaababatababababauabababaaaaaaaaaa
aaaaaaaaaaaaaaaaaaaaaaaaaaaaaaaaaaaaaaaaaaaaaaaaaaaaaaaaaaaaaaaaaaaaabavapawaxayazapaAaBabaaaaaaaaaa
aaaaaaaaaaaaaaaaaaaaaaaaaaaaaaaaaaaaaaaaaaaaaaaaaaaaaaaaaCaCaCaCaCaCabapapapaxaDaEapaFaGaCaaaaaaaaaa
aaaaaaaaaaaaaaaaaaaaaaaaaaaaaaaaaaaaaaaaaaaaaaaaaaaaaaaaaCaHaIaJaKaLabatabaMaNaOaPapaQaRaCaaaaaaaaaa
aaaaaaaaaaaaaaaaaaaaaaaaaaaaaaaaaaaaaaaaaaaaaaaaaaaaaaaaaCaSaSaSaSaSabapapapapapapapaTaTabaaaaaaaaaa
aaaaaaaaaaaaaaaaaaaaaaaaaaaaaaaaaaaaaaaaaaaaaaaaaaaaaaaaaCaUaVaWaXaVababauababababababababaaaaaaaaaa
aaaaaaaaaaaaaaaaaaaaaaaaaaaaaaaaaaaaaaaYaYaYaYaYaaaaaaaaabababaZabababbaapbaabbbanabbcanabaaaaaaaaaa
aaaaaaaaaaaaaaaaaaaaaaaaaaaaaaaaaaaaaaababbdababaaaaaaaaabbebfapapapauapapapabapaoabbgaoabaaaaaaaaaa
aaaaaaaaaaaaaaaaaaaaaaaaaaaaaaaaaaaaaaabbhafbhabaaaaaaaaabapapbiapapabbjbjbjabaCbkabaCbkababababaaaa
aaaaaaaaaaaaaaaaaaaaaaaaaaaaaaaaaaaaaaaCafafafaCaaaaaaaaabblbmapbnboabababababapapapaoapaCaobpabaaaa
aaaaaaaaaaaaaaaaaaaaaaaaaaababababaaaaababbdabababaCaCababababbqabababanbrapbkaobsbsbsapbkapanabaaaa
aaaaaaaaaaaaaaaaaaaaaaaaababbtbtababaCabbuapbvbwbxapapbyabbzbAapbmbvabanasapababababababababababaaaa
aaaaaaaaaaaaaaaaaaaaaaaaabbBafafafbCafbCapapapapapapapapbqapapapapapbDapapbEabbFbGbHabaaaaaaaaaaaaaa
aaaaaaaaaaaaaaaaaaaaaaaaababbIbJababaCabbKapapbwbobzapbnabbwbLapbMapaCanbNapbOapapapabaaaaaaaaaaaaaa
aaaaaaaaaaaaaaaaaaaaaaaaaaababababaaaaababaCaCabababbPababababbQabababababababababababababaaaaaaaaaa
aaaaaaaaaaaaaaaaaaaaaaaaaaaaaaaaaaaaaaaaaaaaaaaaabbaapbRababbSbTbUbSbTbVbSbWbWabbXbSaCbTabaaaaaaaaaa
aaaaaaaaaaaaaaaaaaaaaaaaaaaaaaaaaaaaaaaaabababababbYaoapababbZbTbSbTbZabbTbTbTbVbTbTbVcaabaaaaaaaaaa
aaaaaaaaaaaaaaaaaaaaaaaaaaaaaaaaaaaaaaaaabcbcccdabbjapapbRababbZcebZababbWbWbWabbXbSaCbTabaaaaaaaaaa
aaaaaaaaaaaaaaaaaaaaaaaaaaaaaaaaaaaaaaaaabaoapapcfapaoapapababababababababababababababababaaaaaaaaaa
aaaaaaaaaaaaaaaaaaaaaaaaaaaaaaaaaaaaaaaaabapcccdcgaoapapapbRabchchabcicjckclcmcmaCaocnabaaaaaaaaaaaa
aaaaaaaaaaaaaaaaaaaaaaaaaaaaaaaaaaaaaaaaabapapaocoapapcpaoapcqapapcqapcrapcsaoapaCapcnabaaaaaaaaaaaa
aaaaaaaaaaaaaaaaaaaaaaaaaaaaaaaaaaaaaaaaabababababcmcmaocmcmabchchabctaoancuancrcqapaoabaaaaaaaaaaaa
aaaaaaaaaaaaaaaaaaaaaaaaaaaaaaaaaaaaaaaaaaaaaaaaabababbPabababababababcqabaCaCaCababababaaaaaaaaaaaa
aaaaaaaaaaaaaaaaaaaaaaaaaaaaaaaaaaaaaaaaaaaaaaaaabcvaoapapabaaaaaaaaabapaoapapaoabaaaaaaaaaaaaaaaaaa
aaaaaaaaaaaaaaaaaaaaaaaaaaaaaaaaaaaaaaaaaaaaaaaaabancwcxapabaaaaaaaaabapcyczcycyabaaaaaaaaaaaaaaaaaa
aaaaaaaaaaaaaaaaaaaaaaaaaaaaaaaaaaaaaaaaaaaaaaaaabanananapabaaaaaaaaabababababababaaaaaaaaaaaaaaaaaa
aaaaaaaaaaaaaaaaaaaaaaaaaaaaaaaaaaaaaaaaaaaaaaaaababababababaaaaaaaaaaaaaaaaaaaaaaaaaaaaaaaaaaaaaaaa
aaaaaaaaaaaaaaaaaaaaaaaaaaaaaaaaaaaaaaaaaaaaaaaaaaaaaaaaaaaaaaaaaaaaaaaaaaaaaaaaaaaaaaaaaaaaaaaaaaaa
aaaaaaaaaaaaaaaaaaaaaaaaaaaaaaaaaaaaaaaaaaaaaaaaaaaaaaaaaaaaaaaaaaaaaaaaaaaaaaaaaaaaaaaaaaaaaaaaaaaa
aaaaaaaaaaaaaaaaaaaaaaaaaaaaaaaaaaaaaaaaaaaaaaaaaaaaaaaaaaaaaaaaaaaaaaaaaaaaaaaaaaaaaaaaaaaaaaaaaaaa
aaaaaaaaaaaaaaaaaaaaaaaaaaaaaaaaaaaaaaaaaaaaaaaaaaaaaaaaaaaaaaaaaaaaaaaaaaaaaaaaaaaaaaaaaaaaaaaaaaaa
aaaaaaaaaaaaaaaaaaaaaaaaaaaaaaaaaaaaaaaaaaaaaaaaaaaaaaaaaaaaaaaaaaaaaaaaaaaaaaaaaaaaaaaaaaaaaaaaaaaa
aaaaaaaaaaaaaaaaaaaaaaaaaaaaaaaaaaaaaaaaaaaaaaaaaaaaaaaaaaaaaaaaaaaaaaaaaaaaaaaaaaaaaaaaaaaaaaaaaaaa
aaaaaaaaaaaaaaaaaaaaaaaaaaaaaaaaaaaaaaaaaaaaaaaaaaaaaaaaaaaaaaaaaaaaaaaaaaaaaaaaaaaaaaaaaaaaaaaaaaaa
aaaaaaaaaaaaaaaaaaaaaaaaaaaaaaaaaaaaaaaaaaaaaaaaaaaaaaaaaaaaaaaaaaaaaaaaaaaaaaaaaaaaaaaaaaaaaaaaaaaa
"}
